#################
#...............#
#.##.#.###.#.##.#
#.##.#..#..#.##.#
#....##.#.##....#
#.##....X....##.#
#.##.###.###.##.#
#..X....X....X..#
#.##.###.###.##.#
#.##.........##.#
#....#.#.#.#....#
##.#....C....#.##
#..###.#.#.###..#
##......X......##
#################
